0,0,0,0,0,
0,5,5,0,0,
1,2,2,0,0,
2,5,2,0,0,
3,3,4,0,0,
10,3,3,1,1,
11,2,5,0,1,