0,0,0,0,0,
0,7,7,0,0,
4,1,6,0,0,
0,2,3,0,1,
0,1,2,1,1,
2,3,0,0,0,
0,7,3,1,0,
0,3,5,1,0,
0,3,3,1,0,
1,7,0,0,0,
3,6,6,0,0,
12,5,6,1,1,
11,0,7,0,0,
13,1,3,0,0,
10,3,3,0,0,
100,4,3,0,0,
100,2,6,0,0,